HELLO, I AM AINA FROM SEMESTER 3 OF MY DIPLOMA STUDIES.


- THIS PROGRAM CONTAIN A PYTHON PROGRAMME WITH BEGINNER-LEVEL.
- THIS PROGRAM IS MADE ON OCTOBER 2016

- TO BEGIN: 

	1. EXECUTE FILE "main"
	2. AND THEN, THE PROGRAM WILL BE CONTINOUSLY RUN UNTIL YOU CHOOSE TO QUIT PROGRAM

[APPENDIX]

main = MAIN MENU FOR PYTHON PROGRAM
		
fmenu = Menu for 'FUNCTION'
	calc - option '1) Simple Calculator'
	qotd - option '2) Quote of the day'

lmenu = Menu for 'ITERATION'
	sef - option '1) Sending an email'
	ltdd - option '2) List to do today'

strmenu = Menu for 'STRINGS'
	mstate - option '1) Manipulate Statement'
	tof - option '2) Truth or False'

fimenu = Menu for 'FILES'
	a - option '1) Reading a file'
	x - option '2) Printing 2 files'
		c -  second file of 'x'
	ret - return to menu option in 'FILES'

limenu = Menu for 'LISTS'
	rm2awesome - option '1) 2Ringgit Online Store'
	fun - option '2) Fun Words'

dictm = Menu for 'DICTIONARY'
	cas - option '1) Count a Statement'
	bio -  option '2) Biodata'

listd - Option No. 7

choose - Option No. 8